11111111111111111111111111111111
1P000000000000000000000000000001
10000000000000000000000000000001
10000000000000000000000000000001
10101010101010101010101010000C01
10000000000000000000001011111111
10000000000000000000001011111111
10000000000000000000001011111111
10000000000000000000001E11111111
