111111111111111111111111111111111
1P0000000000000000000000000000001
100000000000000000000000000000001
100000000000000000000000000000001
10101010101010101010101010000C001
100000000000000000000010111111111
100000000000000000000010111111111
100000000000000000000010111111111
10000000000000000000001E111111111
1111111111111111111C1111111111111
