11111111111111111111111111111111
1C000000000000000000000000000001
10000000P00000000C00000000000001
10000000000000000000000000000001
10101010101010101010101010000001
10000000000000000000001011111111
10000000000000000000001011111111
10000000000000000000001011111111
10000000000000000000001011111111
11111111111111111111111111111111
