111111111111
111E1C1P1111
111111111111
